{
	"entities": [
		{
			"type": "player",
			"x": 36,
			"y": 130
		}
	],
	"maps": [
		{
			"name": "fg",
			"width": 20,
			"height": 10,
			"linkWithCollision": false,
			"visible": true,
			"tilesetName": "assets/tiles/tiles.qoi",
			"repeat": false,
			"distance": 1,
			"tilesize": 16,
			"foreground": false,
			"data": [
				[6,6,6,6,6,6,6,6,6,6,6,6,6,6,6,6,6,6,6,6],
				[6,0,0,0,0,0,0,0,0,0,0,0,0,0,0,0,0,0,0,6],
				[6,0,0,0,0,0,0,0,0,0,0,0,0,0,0,0,0,0,0,6],
				[6,0,0,0,0,0,0,0,0,0,0,0,0,0,0,0,0,0,0,6],
				[6,0,0,0,0,0,0,0,0,0,0,0,0,0,0,0,0,0,0,6],
				[6,0,0,0,0,0,0,0,0,0,0,0,0,0,0,0,0,0,0,6],
				[6,0,0,0,0,0,0,0,0,0,0,0,0,0,0,0,0,0,0,6],
				[6,0,0,0,0,0,0,0,0,0,0,0,0,0,0,0,0,0,0,6],
				[6,0,0,0,0,0,0,0,0,0,0,0,0,0,0,0,0,0,0,6],
				[6,6,6,6,6,6,6,6,6,6,6,6,6,6,6,6,6,6,6,6]
			]
		},
		{
			"name": "collision",
			"width": 20,
			"height": 10,
			"linkWithCollision": false,
			"visible": true,
			"tilesetName": null,
			"repeat": false,
			"distance": 1,
			"tilesize": 16,
			"foreground": false,
			"data": [
				[1,1,1,1,1,1,1,1,1,1,1,1,1,1,1,1,1,1,1,1],
				[1,0,0,0,0,0,0,0,0,0,0,0,0,0,0,0,0,0,0,1],
				[1,0,0,0,0,0,0,0,0,0,0,0,0,0,0,0,0,0,0,1],
				[1,0,0,0,0,0,0,0,0,0,0,0,0,0,0,0,0,0,0,1],
				[1,0,0,0,0,0,0,0,0,0,0,0,0,0,0,0,0,0,0,1],
				[1,0,0,0,0,0,0,0,0,0,0,0,0,0,0,0,0,0,0,1],
				[1,0,0,0,0,0,0,0,0,0,0,0,0,0,0,0,0,0,0,1],
				[1,0,0,0,0,0,0,0,0,0,0,0,0,0,0,0,0,0,0,1],
				[1,0,0,0,0,0,0,0,0,0,0,0,0,0,0,0,0,0,0,1],
				[1,1,1,1,1,1,1,1,1,1,1,1,1,1,1,1,1,1,1,1]
			]
		}
	]
}